1111111100000000000001000000000000000000000000005000000000000000000000000000000000000000000000000000
E000000100000000000000000000000000000000000000000000000000000000000000000000000000000000000000000000
1111110111111111111111111111111111111113111111111111111111111111130000000000000000000000000000000000
1000010000000011111200000000000000004111111111111111111111111111110000000000000000000000000000000000
100S010000000011112000000000000000000004111111100000041111111111110000000000000000000000000000000000
10011111111100111200511300000000000000000041111305WWWWW1WWWWWWW1110000000000000000000000000000000000
1000001120000041200511111300000000000000000004110411WWW1WWWWWWW1110000000000000000000000000000000000
10000011000000000051111111130000000000000000000100041WW1WWWWWWW1110000000000000000000000000000000000
10000012000000511111111111111300000000000000000111001WW1WWWWWWW1110000000000000000000000000000000000
10000010051111111111111111111113000000000000000001001WW1WWWWWWW1110000000000000000000000000000000000
10000110011111200041111111111111130000511100000001001WW1WWWWWWW1110000000000000000000000000000000000
100000100111110000000000000000411100001104100000010011WWW1WWWWW1110000000000000000000000000000000000
1000001001111100000000000Y000001111351120041000001001411111WWWW1110000000000000000000000000000000000
10000010011111000005111111113004111111205304100001001000001WWWW1110000000000000000000000000000000000
10000110011111000001111111111000000000004130410001001001WW1WWWW1110000000000000000000000000000000000
10000010011112000001120041111000000000000413041001001001WW1WWWW1110000000000000000000000000000000000
10000010000100000001100001111300000000003041300011001001WW1WWWW1110000000000000000000000000000000000
10000010000100000001100511111130000000001304130010051001WW1WWWW1110000000000000000000000000000000000
10000010000101WWWWW1100111111113000530001000420010011001WW1WWWW1110000000000000000000000000000000000
10005111305101LLLLL1100111111111LLLLLLLL1000000013001001WW1WWWW1110000000000000000000000000000000000
10001111101101LLLLL1100111111111LLLLLLLL1000000011001001WW1WWWW1110000000000000000000000000000000000
100011111L1101LLLLL1100111111111111111111111111110051001WW1WWWW1110000000000000000000000000000000000
10001111LLL101LLLLL1100000000000000000000000410010011001WW1WWWW1110000000000000000000000000000000000
10001111LLL101111111200000511111111111130000010013001001WW1WWWWW110000000000000000000000000000000000
10001111111101000000051111120000100000130000010011001001WW1WWWWW110000000000000000000000000000000000
1000120000010101111111111110001WLW1300130000010010051001WW1WWWWW110000000000000000000000000000000000
1000100000010104242424242420001WLW1100130000010010011001WWWWWWWWW10000000000000000000000000000000000
1000130000010100000000000000001WLW1001100000010040011001WWWWWWWWW10000000000000000000000000000000000
1000111100010100000000000000041WLW110010051LL10000041001WWW51111111300000000000000000000000000000000
1000000000010130005130005130041WLW100110051LL10000001001WW520000000430000000000000000000000000000000
1WWWWWWWW1010120004120004120041WLW1100100511120051301001W5200000000043000000000000000000000000000000
1WWWWWWWW1010100000000000000041WLW100110000000001W10100152001111130001000000000000000000000000000000
1WWWWWWWW10101111LLLLLLLLLLLLL1WWW110010000000004120100120011111113004300000000000000000000000000000
1WWWWWWWW1010111LLLLLLLLLLLLLL1111100110001000100000105200111111111300100000000000000000000000000000
1WW1111111010000WWWWWWWWWWWWWWWW00410010000000000000101001111111111100430000000000000000000000000000
1LL1000000010000WWWWWWWWWWWWWWWW0000001LLLLLLLLLLLLL101001111111111100010000000000000000000000000000
1111000000011111LLLLLLLLLLLLLLLL11111111111111111111101001111111111100010000000000000000000000000000
1000001000511111111111111111111120000000041111112011101001111111111100010000000000000000000000000000
1000001000111111115100000000000000000000000411120011101001111111111200010000000000000000000000000000
1011111111111111111200511111111111100000000000000041101004111111112000010000000000000000000000000000
1000000000000000000005200000000001000000000000000000101000000041120000010000000000000000000000000000
1000000000000000000052000000000052WWWWWWWWWWWWWWWWWW101000000001200000010000000000000000000000000000
11111LLLLL11111111112000000000052WWWWWWWWWWWWWWWWWWW101LLLLLL301000000010000000000000000000000000000
41111111111111111112000000000052WWWWWWWWWWWWWWWWWWWW101LLLLLL101000000010000000000000000000000000000
0000000000000000000000000000052WWWWWWWWWWWWWW1WWWWWW101LLLLLL10101LLLLL10000000000000000000000000000
000000000000000000000000000052WWWW53WWWWWWWWWWWWWWWW101111111101W1LLLLL10000000000000000000000000000
00000000000000000000000000052WWWWW42WWWWWWWWWWW11WWW430000000001W1LLLLL10000000000000000000000000000
0000000000000000000000000052WWWWWWWWWWWWWWWWWWW11WWWW41111111112W1LLLLL10000000000000000000000000000
0000000000000000000000G0001WWWWWWWWWWWW111WWWWWWWWWWWWWWWWWWWWWWW1LLLLL10000000000000000000000000000
0000000000000000000000000013WWWWWWWWWWW111WWWWWWWWWWWWWWWWWWWWWWW1LLLLL10000000000000000000000000000
00000000000000000000000000013WWWWWWWWWWWWWWWWWWWWWW5111111111111111111110000000000000000000000000000
000000000000000000000000000013WWWWWWWWWWWWWWWWWWWW51000000000000000000000000000000000000000000000000
00000000000000000000000000000113WWWWWWWWWWWWWWWWW510000000000000000000000000000000000000000000000000
00000000000000000000000000000001113WWWWWWWWWWWWW5100000000000000000000000000000000000000000000000000
0000000000000000000000000000000000113WWWWWW511111000000000000000000000000000000000000000000000000000
0000000000000000000000000000000000001111111100000000000000000000000000000000000000000000000000000000
0000000000000000000000000000000000000000000000000000000000000000000000000000000000000000000000000000
0000000000000000000000000000000000000000000000000000000000000000000000000000000000000000000000000000
0000000000000000000000000000000000000000000000000000000000000000000000000000000000000000000000000000
0000000000000000000000000000000000000000000000000000000000000000000000000000000000000000000000000000
0000000000000000000000000000000000000000000000000000000000000000000000000000000000000000000000000000
0000000000000000000000000000000000000000000000000000000000000000000000000000000000000000000000000000
0000000000000000000000000000000000000000000000000000000000000000000000000000000000000000000000000000
0000000000000000000000000000000000000000000000000000000000000000000000000000000000000000000000000000
0000000000000000000000000000000000000000000000000000000000000000000000000000000000000000000000000000
0000000000000000000000000000000000000000000000000000000000000000000000000000000000000000000000000000
0000000000000000000000000000000000000000000000000000000000000000000000000000000000000000000000000000
0000000000000000000000000000000000000000000000000000000000000000000000000000000000000000000000000000
0000000000000000000000000000000000000000000000000000000000000000000000000000000000000000000000000000
0000000000000000000000000000000000000000000000000000000000000000000000000000000000000000000000000000
0000000000000000000000000000000000000000000000000000000000000000000000000000000000000000000000000000
0000000000000000000000000000000000000000000000000000000000000000000000000000000000000000000000000000
0000000000000000000000000000000000000000000000000000000000000000000000000000000000000000000000000000
0000000000000000000000000000000000000000000000000000000000000000000000000000000000000000000000000000
0000000000000000000000000000000000000000000000000000000000000000000000000000000000000000000000000000
0000000000000000000000000000000000000000000000000000000000000000000000000000000000000000000000000000
0000000000000000000000000000000000000000000000000000000000000000000000000000000000000000000000000000
0000000000000000000000000000000000000000000000000000000000000000000000000000000000000000000000000000
0000000000000000000000000000000000000000000000000000000000000000000000000000000000000000000000000000
0000000000000000000000000000000000000000000000000000000000000000000000000000000000000000000000000000
0000000000000000000000000000000000000000000000000000000000000000000000000000000000000000000000000000
0000000000000000000000000000000000000000000000000000000000000000000000000000000000000000000000000000
0000000000000000000000000000000000000000000000000000000000000000000000000000000000000000000000000000
0000000000000000000000000000000000000000000000000000000000000000000000000000000000000000000000000000
0000000000000000000000000000000000000000000000000000000000000000000000000000000000000000000000000000
0000000000000000000000000000000000000000000000000000000000000000000000000000000000000000000000000000
0000000000000000000000000000000000000000000000000000000000000000000000000000000000000000000000000000
0000000000000000000000000000000000000000000000000000000000000000000000000000000000000000000000000000
0000000000000000000000000000000000000000000000000000000000000000000000000000000000000000000000000000
0000000000000000000000000000000000000000000000000000000000000000000000000000000000000000000000000000
0000000000000000000000000000000000000000000000000000000000000000000000000000000000000000000000000000
0000000000000000000000000000000000000000000000000000000000000000000000000000000000000000000000000000
0000000000000000000000000000000000000000000000000000000000000000000000000000000000000000000000000000
0000000000000000000000000000000000000000000000000000000000000000000000000000000000000000000000000000
0000000000000000000000000000000000000000000000000000000000000000000000000000000000000000000000000000
0000000000000000000000000000000000000000000000000000000000000000000000000000000000000000000000000000
0000000000000000000000000000000000000000000000000000000000000000000000000000000000000000000000000000
0000000000000000000000000000000000000000000000000000000000000000000000000000000000000000000000000000
0000000000000000000000000000000000000000000000000000000000000000000000000000000000000000000000000000
0000000000000000000000000000000000000000000000000000000000000000000000000000000000000000000000000000
