0000000000000000000000000000000000000000000000000000000000000000000000000000000000000000000000000000
0000000000000000000000000000000000000000000000000000000000000000000000000000000000000000000000000000
0000000000000000000000000000000000000000000000000000000000000000000000000000000000000000000000000000
0000000000000000000000000000000000000000000000000000000000000000000000000000000000000000000000000000
0111000000000000000000000000000000000000000000000000000000000000000000000000000000000000000000000000
01S1000000000000000000000000000000000000000000000000000000000000000000000000000000000000000000000000
0101111111111111111111111111111111111111111111111111111111111110000000000000000000000000000000000000
0100000000000000000000000000000000000000000000000000000000000L10000000000000000000000000000000000000
0101110111111111111111111011111111111101111111111111110111111110000000000000000000000000000000000000
0100010000000000000000001000000000000100000000000000010000000L10000000000000000000000000000000000000
0111011111111110111111101111111111110111111111111111011111111110000000000000000000000000000000000000
0101000000000010000000100000000000010000000000000001000000000L10000000000000000000000000000000000000
0101011111111011111110101111111111010111111111111101011111101110000000000000000000000000000000000000
0101000000001000000010100000000001010000000000000101000000100L10000000000000000000000000000000000000
0101111101101011111010111111111101011111111111110101111111111110000000000000000000000000000000000000
0100000100101000001010000000000101000000000000010100000000000L10000000000000000000000000000000000000
0111111111101111101010111111110101011111111111010101111111111110000000000000000000000000000000000000
0100000000100000101010000000010101000000000001010100000000000L10000000000000000000000000000000000000
0100000000101110101011111111010101111111111101010111111111111110000000000000000000000000000000000000
0100000000100010101000000001010100000000000101010000000000000L10000000000000000000000000000000000000
0100000000111110101011111101010101111111110101010111111111111110000000000000000000000000000000000000
0100000000000010101000000101010100000000010101010000000000000L10000000000000000000000000000000000000
0101130101001010101111110101010111111111010101011111111111111110000000000000000000000000000000000000
0101010001301010100000010101010000000001010101000000000000000L10000000000000000000000000000000000000
0101020301101010101111010101010111111101010101011111111111111110000000000000000000000000000000000000
0101130101431010100001010101010000000101010101000000000000000L10000000000000000000000000000000000000
0101010101011010111101010101011111110101010101111111111111111110000000000000000000000000000000000000
0101010101041010000101010101000000010101010100000000000000000E10000000000000000000000000000000000000
0101120401001010110101010101011111010101010101111111111111111110000000000000000000000000000000000000
0100000000000010010101010101010000010101010100000000000000000L10000000000000000000000000000000000000
0100000000111111010101010101111111110101010111111111111111111110000000000000000000000000000000000000
0100000000000001010101010100000010010101010000000000000000000L10000000000000000000000000000000000000
0100000110000001010101010101111111010101010111111111111111111110000000000000000000000000000000000000
0100000000000001010101010100001000010101010000000000000000000L10000000000000000000000000000000000000
0100110000000001010101010111111111010101011111111111111111111110000000000000000000000000000000000000
0100000000000001010101010001000000010101000000000000000000000L10000000000000000000000000000000000000
0110000000000001010101010111111111110101011111111111111111111110000000000000000000000000000000000000
0100000000000001010101010000000000010101000000000000000000000L10000000000000000000000000000000000000
0100110000000001010101011111111111010101111111111111111111111110000000000000000000000000000000000000
0100000000000001010101000000100000010100000000000000000000000L10000000000000000000000000000000000000
0100000110000001010101011111111111010101111111111111111111111110000000000000000000000000000000000000
0100000000000001010101000010000001110100000000000000000000000L10000000000000000000000000000000000000
0100000000110001010101111111111111010111111111111111111111111110000000000000000000000000000000000000
0100000000000000010100000000000000010000000000000000000000000L10000000000000000000000000000000000000
01L0000000000111010101111111111111110111111111111111111111111110000000000000000000000000000000000000
011LLLLLLLLLLLL1010100000000000000010000000000000000000000000L10000000000000000000000000000000000000
0011111111111111111111111111111111111111111111111111111111111110000000000000000000000000000000000000
0000000000000000000000000000000000000000000000000000000000000000000000000000000000000000000000000000
0000000000000000000000000000000000000000000000000000000000000000000000000000000000000000000000000000
0000000000000000000000000000000000000000000000000000000000000000000000000000000000000000000000000000
0000000000000000000000000000000000000000000000000000000000000000000000000000000000000000000000000000
0000000000000000000000000000000000000000000000000000000000000000000000000000000000000000000000000000
0000000000000000000000000000000000000000000000000000000000000000000000000000000000000000000000000000
0000000000000000000000000000000000000000000000000000000000000000000000000000000000000000000000000000
0000000000000000000000000000000000000000000000000000000000000000000000000000000000000000000000000000
0000000000000000000000000000000000000000000000000000000000000000000000000000000000000000000000000000
0000000000000000000000000000000000000000000000000000000000000000000000000000000000000000000000000000
0000000000000000000000000000000000000000000000000000000000000000000000000000000000000000000000000000
0000000000000000000000000000000000000000000000000000000000000000000000000000000000000000000000000000
0000000000000000000000000000000000000000000000000000000000000000000000000000000000000000000000000000
0000000000000000000000000000000000000000000000000000000000000000000000000000000000000000000000000000
0000000000000000000000000000000000000000000000000000000000000000000000000000000000000000000000000000
0000000000000000000000000000000000000000000000000000000000000000000000000000000000000000000000000000
0000000000000000000000000000000000000000000000000000000000000000000000000000000000000000000000000000
0000000000000000000000000000000000000000000000000000000000000000000000000000000000000000000000000000
0000000000000000000000000000000000000000000000000000000000000000000000000000000000000000000000000000
0000000000000000000000000000000000000000000000000000000000000000000000000000000000000000000000000000
0000000000000000000000000000000000000000000000000000000000000000000000000000000000000000000000000000
0000000000000000000000000000000000000000000000000000000000000000000000000000000000000000000000000000
0000000000000000000000000000000000000000000000000000000000000000000000000000000000000000000000000000
0000000000000000000000000000000000000000000000000000000000000000000000000000000000000000000000000000
0000000000000000000000000000000000000000000000000000000000000000000000000000000000000000000000000000
0000000000000000000000000000000000000000000000000000000000000000000000000000000000000000000000000000
0000000000000000000000000000000000000000000000000000000000000000000000000000000000000000000000000000
0000000000000000000000000000000000000000000000000000000000000000000000000000000000000000000000000000
0000000000000000000000000000000000000000000000000000000000000000000000000000000000000000000000000000
0000000000000000000000000000000000000000000000000000000000000000000000000000000000000000000000000000
0000000000000000000000000000000000000000000000000000000000000000000000000000000000000000000000000000
0000000000000000000000000000000000000000000000000000000000000000000000000000000000000000000000000000
0000000000000000000000000000000000000000000000000000000000000000000000000000000000000000000000000000
0000000000000000000000000000000000000000000000000000000000000000000000000000000000000000000000000000
0000000000000000000000000000000000000000000000000000000000000000000000000000000000000000000000000000
0000000000000000000000000000000000000000000000000000000000000000000000000000000000000000000000000000
0000000000000000000000000000000000000000000000000000000000000000000000000000000000000000000000000000
0000000000000000000000000000000000000000000000000000000000000000000000000000000000000000000000000000
0000000000000000000000000000000000000000000000000000000000000000000000000000000000000000000000000000
0000000000000000000000000000000000000000000000000000000000000000000000000000000000000000000000000000
0000000000000000000000000000000000000000000000000000000000000000000000000000000000000000000000000000
0000000000000000000000000000000000000000000000000000000000000000000000000000000000000000000000000000
0000000000000000000000000000000000000000000000000000000000000000000000000000000000000000000000000000
0000000000000000000000000000000000000000000000000000000000000000000000000000000000000000000000000000
0000000000000000000000000000000000000000000000000000000000000000000000000000000000000000000000000000
0000000000000000000000000000000000000000000000000000000000000000000000000000000000000000000000000000
0000000000000000000000000000000000000000000000000000000000000000000000000000000000000000000000000000
0000000000000000000000000000000000000000000000000000000000000000000000000000000000000000000000000000
0000000000000000000000000000000000000000000000000000000000000000000000000000000000000000000000000000
0000000000000000000000000000000000000000000000000000000000000000000000000000000000000000000000000000
0000000000000000000000000000000000000000000000000000000000000000000000000000000000000000000000000000
0000000000000000000000000000000000000000000000000000000000000000000000000000000000000000000000000000
0000000000000000000000000000000000000000000000000000000000000000000000000000000000000000000000000000
