0000000000000000000000000000000000000000000000000000000000000000000000000000000000000000000001110000
0111000000000000000000000000000011111111111111111111111111111111111111100000000000000000000001r10000
01g1000000000000000000000000000010000000000000000000y00000000000000000100000000000000000000001010000
0101000000000000000000000000000010000000000000000000100000000001000000100000000000000000000001010000
0101000000000000000000000000000010000000e00e0000000t10t0ee000010100000100000000000000000000001010000
0101000000000000000000000000000010000000000000010000100000001000000000100000000000000000000001010000
0101000000000000000000000000000010000000000010100111101001000e00000000100000000000000000000001010000
0101000000000000000000000000000010000000000100000000111100000e00000000100000000000000000000001010000
0101000000000000000000000000000010000000000100000000101001000e00000000111111111111111000000001010000
010100000000000000000000000000001000000000000000000010000001000000t000G00g00t00000001000000001010000
0101000000000000001111111111111110000000000000000000100000000000000000111111111111111000000001010000
010100000000000000100000000t0y00Y000000000e00eee0000100000000000000000111111111111111000000001010000
010100000000000000100000000000001000t00e000000000000100e00011100000000G00g00t00000001000000001010000
010100000000000000111111111111111000t00ee0000000010010ee00000010000000111111111111111000000001010000
010100000000000000100000000t0y00Y0000000010110011111100000000110000000100000000000000000000001010000
0101000000000000001111111111111110000000000000000001111111100110000000111111111111111111111111010000
01011111111111111111111111111111100000000000000000001000000001000t0000G00g00t00000000000000000010000
010000000000000000000000000t0y00Y0000t000001000000001000000000000t0000111111111111111111111111110000
0111111111111111111111111111111110000000000000000000100000000000000000100000000000000000000000000000
0000000000000000001111111111111110000000e00010000000100000000000000000111111111111111000000000000000
000000000000000000100000000t0y00Y0000000e00001111111111111010110000000G00g00t00000001000000000000000
0000000000000000001111111111111110000000000000000000100110000000000000111111111111111000000000000000
00000000000000000000000000000000100t00000100000000001000000000000tt000100000000000000000000000000000
00000000000000000000000000000000100000000100e000000010000100000000t000100000000000000000000000000000
0000000000000000000000000000000010000001111100e00eee100001000000000000111111111111111000000000000000
000000000000000000111111111111111000000000000000001e110010000110000000B00b00t00000001000000000000000
000000000000000000100000000t0r00R000t000000000010000100000011101000000111111111111111000000000000000
0000000000000000001111111111111110000000000101000000100000010000000000100000000000000000000000000000
000000000000000000000000000000001000000000100000000010000010000000t000100000000000000000000000000000
0111111111111111111111111111111110000000001000000000100000100000000000111111111111111111111111110000
010000000000000000000000000t0r00R0000000000100000000100000000000000000B00b00t00000000000000000010000
01011111111111111111111111111111100t0000000000001010100000000000000000111111111111111111111111010000
0101000000000000000000000000000010000000000000000000100000000111000000100000000000000000000001010000
010100000000000000000000000000001000000011110010100110000011100000t000100000000000000000000001010000
010100000000000000111111111111111000000000010000000010000000000000t000111111111111111000000001010000
010100000000000000100000000t0r00R000000000000000000010000000000000t000B00b00t00000001000000001010000
010100000000000000111111111111111000000000000001100010000000000000t000111111111111111000000001010000
01010000000000000000000000000000100t0000000000000000100000000000000000100000000000000000000001010000
0101000000000000001111111111111110000000000000000000100000000000000000100000000000000000000001010000
010100000000000000100000000t0r00R0000000000000000000100000000000000000111111111111111000000001010000
01010000000000000011111111111111170000000000000000001000000000000t0000B00b00t00000001000000001010000
0101000000000000000000000000000010700000000000000000100000000000000009111111111111111000000001010000
010100000000000000000000000000001007000000000000000010000000t000000090100000000000000000000001010000
0101000000000000000000000000000010007000000000000000100000000000000900100000000000000000000001010000
0101000000000000000000000000000010000700000000000000100000000000009000100000000000000000000001010000
01b1000000000000000000000000000010000070000000000000100000000000090000100000000000000000000111010000
011100000000000000000000000000001000000700000000000010000000000090000010000000000000000000010E010000
0000000000000000000000000000000010000000700000000000100000000009000000100000000000000000000111110000
0000000000000000000000000000000010000000070000000000100000000090000000100000000000000000000000000000
0000000000000000000000000000000010000000007000000000100000000900000000100000000000000000000000000000
0000000000000000000000000000000010000000000700000000100000009000000000100000000000000000000000000000
0000000000000000000000000000000010000000000070000000100000000000000000100000000000000000000000000000
0000000000000000000000000000000010000000000007000000000000900000000000100000000000000000000000000000
0000000000000000000000000000000011111111111111701111111109111111111110100000000000000000000000000000
0000000000000000000000000000000010000000000000I0I000000I0I000000000000100000000000000000000000000000
0000000000000000000000000000000010000000000000000000000000000000ee0000100000000000000000000000000000
0000000000000000000000000000000010000000000000000000000000000000e00000100000000000000000000000000000
0000000000000000000000000000000010000000e00000000000000000000000000000100000000000000000000000000000
00000000000000000000000000000000100IIIIIIIIIIII0IIIIIIII0IIIIIIIIIIIII100000000000000000000000000000
0000000000000000000000000000000010000000000000e000000000e0000000000000100000000000000000000000000000
000000000000000000000000000000001000000000000e000000000000000000000000100000000000000000000000000000
000000000000000000000000000000001000000000000000000000000000e000000e00100000000000000000000000000000
000000000000000000000000000000001IIIIIIIIIIIIII0IIIIIIII0IIIIIIIIII000100000000000000000000000000000
0000000000000000000000000000000010000000000000000000000000000000000000100000000000000000000000000000
000000000000000000000000000000001000000000000000000000e000000000000000100000000000000000000000000000
00000000000000000000000000000000100000000e0000000e0000000000e000000000100000000000000000000000000000
0000000000000000000000000000000010000000000000000000000000000000000000100000000000000000000000000000
0000000000000000000000000000000010000000000000000000000000000000000000100000000000000000000000000000
0000000000000000000000000000000010000000000000000000S00000000000000000100000000000000000000000000000
0000000000000000000000000000000011111111111111111111111111111111111111100000000000000000000000000000
0000000000000000000000000000000000000000000000000000000000000000000000000000000000000000000000000000
0000000000000000000000000000000000000000000000000000000000000000000000000000000000000000000000000000
0000000000000000000000000000000000000000000000000000000000000000000000000000000000000000000000000000
0000000000000000000000000000000000000000000000000000000000000000000000000000000000000000000000000000
0000000000000000000000000000000000000000000000000000000000000000000000000000000000000000000000000000
0000000000000000000000000000000000000000000000000000000000000000000000000000000000000000000000000000
0000000000000000000000000000000000000000000000000000000000000000000000000000000000000000000000000000
0000000000000000000000000000000000000000000000000000000000000000000000000000000000000000000000000000
0000000000000000000000000000000000000000000000000000000000000000000000000000000000000000000000000000
0000000000000000000000000000000000000000000000000000000000000000000000000000000000000000000000000000
0000000000000000000000000000000000000000000000000000000000000000000000000000000000000000000000000000
0000000000000000000000000000000000000000000000000000000000000000000000000000000000000000000000000000
0000000000000000000000000000000000000000000000000000000000000000000000000000000000000000000000000000
0000000000000000000000000000000000000000000000000000000000000000000000000000000000000000000000000000
0000000000000000000000000000000000000000000000000000000000000000000000000000000000000000000000000000
0000000000000000000000000000000000000000000000000000000000000000000000000000000000000000000000000000
0000000000000000000000000000000000000000000000000000000000000000000000000000000000000000000000000000
0000000000000000000000000000000000000000000000000000000000000000000000000000000000000000000000000000
0000000000000000000000000000000000000000000000000000000000000000000000000000000000000000000000000000
0000000000000000000000000000000000000000000000000000000000000000000000000000000000000000000000000000
0000000000000000000000000000000000000000000000000000000000000000000000000000000000000000000000000000
0000000000000000000000000000000000000000000000000000000000000000000000000000000000000000000000000000
0000000000000000000000000000000000000000000000000000000000000000000000000000000000000000000000000000
0000000000000000000000000000000000000000000000000000000000000000000000000000000000000000000000000000
0000000000000000000000000000000000000000000000000000000000000000000000000000000000000000000000000000
0000000000000000000000000000000000000000000000000000000000000000000000000000000000000000000000000000
0000000000000000000000000000000000000000000000000000000000000000000000000000000000000000000000000000
0000000000000000000000000000000000000000000000000000000000000000000000000000000000000000000000000000
0000000000000000000000000000000000000000000000000000000000000000000000000000000000000000000000000000
0000000000000000000000000000000000000000000000000000000000000000000000000000000000000000000000000000
