000000000000000000000000000000000000000000000000000I000000000000000000000000000000000000000000000000
0000000000000000000000000000000000000000000000000000000000000000000000000000000000000000000000000000
111111IIIIIIIIIIIIIIIIIIIIIIIIIIIIIIIIIIIIIIIIIIIIIIIIIIIIIIIIII130000000000000000000000000000000000
I00001000000000000000000000000000000000000001I000000000000000000110000000000000000000000000000000000
I000S1E00000000000000000000000000000000000001I000000000000000000110000000000000000000000000000000000
I00111111111111110000000000000000000000000001I000011000000000000010000000000000000000000000000000000
I000001IIIIIIIIII1000000000000000000000000001I000110111000000000010000000000000000000000000000000000
I000001I000000000I100000000000000000000000001I0011000011WWWWWWWWW10000000000000000000000000000000000
I00000120000000000I11000000000000000000010001I00I0000001WWWWWWWWW10000000000000000000000000000000000
I00000100000000000000000000000000000000000001I0I10001001WWIIIIIII10000000000000000000000000000000000
I00000100000000000000000000100010010100000001I0I10001001WWWWWWWWW10000000000000000000000000000000000
I0000010000I000000000000000000000000000000001I0I10001001WWWWWWWWW10000000000000000000000000000000000
I0000010000I0000000000000Y0000000000000000001I0I1000I00111IIIWWII10000000000000000000000000000000000
I0000010000I0011111II0I0I0I0I0I0I0I0III000001I0I1000I00000IWWWWWW10000000000000000000000000000000000
I0000010000I0010000I000000000000000000I000001I0I1000IWW1WWIWWWWWW10000000000000000000000000000000000
I0000010000I0010000I000000000000000000I000001I0I1300IWW1WWIIIIIWW10000000000000000000000000000000000
I000001000000010000I000000000000000000I000001I0I11001WW1WWIWWWWWW10000000000000000000000000000000000
I0000010000I0000000I0000000000000000000000001I0I12051WWWWWIWWIIII10000000000000000000000000000000000
I0000013000IIIWWWWWIIII30000005300005111I0001I0I10011WWWWWIWWWWWW10000000000000000000000000000000000
I0000011305IIILLLLL11LLLLLLLLLLLLLLLLLLLII001I0I13041WW1WWIWWWWWW10000000000000000000000000000000000
I000001110IIIILLLLL11LLLLLLLLLLLLLLLLLLLII001I0I11001WW1WWIWWWWWW10000000000000000000000000000000000
I00000111LIIIILLLLL111111111111111111111I0001I0I12051WW1WWIIIIIWW10000000000000000000000000000000000
I0000011LLL1IILLLLL11000000000000000001000001I0I10011WWWWWIWWWWWW10000000000000000000000000000000000
I0000011LLL1111111112000005111111111001000001I0I13041WWWWWIWWWWWW10000000000000000000000000000000000
I0000011111100000000051111120000000I001000001I0I11001WWWWWIWWIIII10000000000000000000000000000000000
I00000000001000IIIIIIIIIIII0001WWWWI001001111I0I12051WW1WWIWWWWWW10000000000000000000000000000000000
I000000000010000000000000000001WWWWI301000000I0I10011WW1WWWWWWWWW10000000000000000000000000000000000
I000000000010000000000000000001WWLLI051000000I0I10041WW1WWWWWWWWW10000000000000000000000000000000000
I000000000010000000000000000001WWWWI30100IILLI0I10001WW1WWW5IIIIIII300000000000000000000000000000000
I00000000001II3000513000513005IWWWWI051000ILLI0I10001WWWWW520000000430000000000000000000000000000000
1WWWWWWWW101III000412000412004ILLWWI301000IIII0011301WWWW5200000000043000000000000000000000000000000
1WWWWWWWW101IIII00000000000000IWWWWI0510000000001W1011WW12001111130001000000000000000000000000000000
1WWWWWWWW1010111LLLLLLLLLLLLLL1WWWWI3010000000004120001120011111113004300000000000000000000000000000
1WWWWWWWW1011111LLLLLLLLLLLLLL1WWLLI0510001000100100001200111111111300100000000000000000000000000000
1WW1111111000000WWWWWWWWWWWWWWWWWWWI001000000000010000I001111111111100430000000000000000000000000000
1LL1000001000000WWWWWWWWWWWWWWWWWWWI001LLLLLLLLLL1LL10I0011111111111000I0000000000000000000000000000
1111011101111111LLLLLLLLLLLLLLLL111I001111111111111110I0011111111111000I0000000000000000000000000000
100001K10111111111111111111111112100000010000000000010I0011111111111000I0000000000000000000000000000
100001000100000000000000000000000100000010000000000010I0011111111112000I0000000000000000000000000000
100001111100000000000000000000000100000010000000000010I0041111111120000I0000000000000000000000000000
100000000000000000000000000000000100000010000000000010I0000000411200000I0000000000000000000000000000
1000000000000000000000000000000052WWWWWW1WWWWWWWWWWW10I0000000012000000I0000000000000000000000000000
11111LLLL100000000000000000000052WWWWWWW1WWWWWWWWWWW101LLLLLL3010000000I0000000000000000000000000000
4111111111I000000000000000000052WWWWW1WW1WWWWWWWWWWW101LLLLLL1010000000I0000000000000000000000000000
0000000000II0000000000000000052WWWWWWWWW1WWWW1WWWWWW101LLLLLL10101LLLLL10000000000000000000000000000
00000000000II00000000000000052WWWW53WWWW1WWWWWWWWWWW101111111101W1LLLLL10000000000000000000000000000
000000000000II000000000000052WWWWW42WWWW1WWWWWW11WWW430000000001W1LLLLL10000000000000000000000000000
0000000000000II0000000000052WWWWWWWWWWWW1WWWWWW11WWWW41111111112W1LLLLL10000000000000000000000000000
00000000000000II000000G0001WWWWWWWWWWWW111WWWWWWWWWWWWWWWWWWWWWWW1LLLLL10000000000000000000000000000
000000000000000II00000000013WWWWWWW1WWW111WWWWWWWW1WWWWWWWWWWWWWW1LLLLL10000000000000000000000000000
00000000000000001000000000013WWW1WWWWWWWWWWWWWWWWWW5111111111111111111110000000000000000000000000000
000000000000000010000000000013WWWWWWWWWWWWWWW1WWWW51000000000000000000000000000000000000000000000000
00000000000000001000000000000113WWWWWWWWWWWWWWWWW510000000000000000000000000000000000000000000000000
00000000000000001000000000000001113WWWW1WWWWWWWW5100000000000000000000000000000000000000000000000000
0000000000000000100000000000000000113WWWWWW511111000000000000000000000000000000000000000000000000000
00000000000000001WWWWWWWWWWWWWWWWWWW111W111100000000000000000000000000000000000000000000000000000000
00000000000000001111111111WWWWWWWWWWWWWW100000000000000000000000000000000000000000000000000000000000
0000000000000000111111111111111111111111100000000000000000000000000000000000000000000000000000000000
0000000000000000000000000000000000000000000000000000000000000000000000000000000000000000000000000000
0000000000000000000000000000000000000000000000000000000000000000000000000000000000000000000000000000
0000000000000000000000000000000000000000000000000000000000000000000000000000000000000000000000000000
0000000000000000000000000000000000000000000000000000000000000000000000000000000000000000000000000000
0000000000000000000000000000000000000000000000000000000000000000000000000000000000000000000000000000
0000000000000000000000000000000000000000000000000000000000000000000000000000000000000000000000000000
0000000000000000000000000000000000000000000000000000000000000000000000000000000000000000000000000000
0000000000000000000000000000000000000000000000000000000000000000000000000000000000000000000000000000
0000000000000000000000000000000000000000000000000000000000000000000000000000000000000000000000000000
0000000000000000000000000000000000000000000000000000000000000000000000000000000000000000000000000000
0000000000000000000000000000000000000000000000000000000000000000000000000000000000000000000000000000
0000000000000000000000000000000000000000000000000000000000000000000000000000000000000000000000000000
0000000000000000000000000000000000000000000000000000000000000000000000000000000000000000000000000000
0000000000000000000000000000000000000000000000000000000000000000000000000000000000000000000000000000
0000000000000000000000000000000000000000000000000000000000000000000000000000000000000000000000000000
0000000000000000000000000000000000000000000000000000000000000000000000000000000000000000000000000000
0000000000000000000000000000000000000000000000000000000000000000000000000000000000000000000000000000
0000000000000000000000000000000000000000000000000000000000000000000000000000000000000000000000000000
0000000000000000000000000000000000000000000000000000000000000000000000000000000000000000000000000000
0000000000000000000000000000000000000000000000000000000000000000000000000000000000000000000000000000
0000000000000000000000000000000000000000000000000000000000000000000000000000000000000000000000000000
0000000000000000000000000000000000000000000000000000000000000000000000000000000000000000000000000000
0000000000000000000000000000000000000000000000000000000000000000000000000000000000000000000000000000
0000000000000000000000000000000000000000000000000000000000000000000000000000000000000000000000000000
0000000000000000000000000000000000000000000000000000000000000000000000000000000000000000000000000000
0000000000000000000000000000000000000000000000000000000000000000000000000000000000000000000000000000
0000000000000000000000000000000000000000000000000000000000000000000000000000000000000000000000000000
0000000000000000000000000000000000000000000000000000000000000000000000000000000000000000000000000000
0000000000000000000000000000000000000000000000000000000000000000000000000000000000000000000000000000
0000000000000000000000000000000000000000000000000000000000000000000000000000000000000000000000000000
0000000000000000000000000000000000000000000000000000000000000000000000000000000000000000000000000000
0000000000000000000000000000000000000000000000000000000000000000000000000000000000000000000000000000
0000000000000000000000000000000000000000000000000000000000000000000000000000000000000000000000000000
0000000000000000000000000000000000000000000000000000000000000000000000000000000000000000000000000000
0000000000000000000000000000000000000000000000000000000000000000000000000000000000000000000000000000
0000000000000000000000000000000000000000000000000000000000000000000000000000000000000000000000000000
0000000000000000000000000000000000000000000000000000000000000000000000000000000000000000000000000000
0000000000000000000000000000000000000000000000000000000000000000000000000000000000000000000000000000
0000000000000000000000000000000000000000000000000000000000000000000000000000000000000000000000000000
0000000000000000000000000000000000000000000000000000000000000000000000000000000000000000000000000000
0000000000000000000000000000000000000000000000000000000000000000000000000000000000000000000000000000
0000000000000000000000000000000000000000000000000000000000000000000000000000000000000000000000000000
