0000000000000000000000000000000000000000000000L00000000000000000000000000000000000000000000000000000
0000000000000000000000000000000000000000000000000000111111111111111111111111111111100000000000000000
0000000000000000000000000000000000000000000000000000I00000000000000000000000000000100000000000000000
0000000000000000000000000000000000000000000000000000I01111111111111111111111111110100000000000000000
0000000000000000000000000000000000000000000000000000I0I000000000000000000000000010100000000000000000
0000000000000000000000000000000000000000000000000000I0I000000000000000000000000010100000000000000000
0000000000000000000000000000000000000000000000000000I0I000000000000000000000000010100000000000000000
0000000000000000000000000000000000000000000000000000I0I000000000000000000000000010100000000000000000
0000000000000000000000000000000000000000000000000000I0I000000000000000000000000010100000000000000000
000000000000000000000000000000000111111111IIIII11111I0I000000000000000000000000010100000000000000000
0000000000000000000000000000000001ee1000t00000000000001000000000000000000000000010100000000000000000
0000000000000000000000000000000001beG0005I70009I3000001000000000000000000000000010100000000000000000
000000000000000000000000000000000111111111IsssI11110004111111111111111111111111110100000000000000000
0000000000000000000000000000000001eeeeeeeee000eeee100000000e0000000000000e10000010100000000000000000
0000000000000000000000000000000001eeeeeeeee000eeee100000000000000000000000R0000y10100000000000000000
0000000000000000000000000000000001LLLLLLLLL111111110091111111111ss1ss1111111111110100000000000000000
0000000000000000000000000000000001LLLLLLLLL1000005209I0000000001WW1LLLLLLLLLLLLL1W100000000000000000
0000000000000000000000000000000001111111111100005209I00000000001WW1LLLLLLLLLLLLL1W100000000000000000
000000000000000000000000000000000000000000000005209I000000000001WW1LLLLLLLLLLLLL1W100000000000000000
00000000000000000000000000000000000000000000005209I0000000000001WW1LLLLLLLLLLLLL1W100000000000000000
0000000000000000000000000000000000000000000005209I00000000000001WW111111111111111W100000000000000000
000000000000000000000000000000000000000000005209I000000000000001WWWWWWWWWeWWWWWrWW100000000000000000
00000000000000000000000000000000000000000005209I0000000000000001111111111111111111100000000000000000
0000000000000000000000000000000000000000005209I10000000000000000000000000000000000000000000000000000
000000000000000000000000000000000000000005209I011000000000000000000000000000000000000000000000000000
00000000000000000000000000000000000000005209I0001100000000000000000000000000000000000000000000000000
0000000000000000000000000000000000000005209I00000110000000000000000000000000000000000000000000000000
000000000000000000000000000000000000005209I000000011000000000000000000000000000000000000000000000000
00000000000000000000000000000000000005209I0000000001100000000000000000000000000000000000000000000000
0000000000000000000000000000000000005209I00t0000t000110000000000000000000000000000000000000000000000
000000000000000000000000000000000005209I000000000000011000000000000000000000000000000000000000000000
00000000000000000000000001111111111209I1000000000000001110000000000000000000000000000000000000000000
00000000000000000000000001001t0000000000000t00000000001010000000000000000000000000000000000000000000
00000000000000000000000001g0Y000000000000000000000000SBE10000000000000000000000000000000000000000000
000000000000000000000000011111111WWW111111IIIIIII111111110000000000000000000000000000000000000000000
00000000000000000000000001WWWWWWWWWW1000000000000000000000000000000000000000000000000000000000000000
00000000000000000000000001WWWWWWWWW11000000000000000000000000000000000000000000000000000000000000000
00000000000000000000000001WWWWWWWWW10000000000000000000000000000000000000000000000000000000000000000
00000000000000000000000001WWWWWWWW100000000000000000000000000000000000000000000000000000000000000000
00000000000000000000000001WWWWWWWW100000000000000000000000000000000000000000000000000000000000000000
00000000000000000000000001WWWWWWW1100000000000000000000000000000000000000000000000000000000000000000
00000000000000000000000001WWWWWWW1000000000000000000000000000000000000000000000000000000000000000000
00000000000000000000000001WWWWWW11000000000000000000000000000000000000000000000000000000000000000000
00000000000000000000000001WWWWWW10000000000000000000000000000000000000000000000000000000000000000000
00000000000000000000000001WWWWW110000000000000000000000000000000000000000000000000000000000000000000
00000000000000000000000001WWWWW100000000000000000000000000000000000000000000000000000000000000000000
00000000000000000000000001WWWW1100000000000000000000000000000000000000000000000000000000000000000000
00000000000000000000000001WWWW1000000000000000000000000000000000000000000000000000000000000000000000
00000000000000000000000001WWW11000000000000000000000000000000000000000000000000000000000000000000000
0000000000000000000000000111110000000000000000000000000000000000000000000000000000000000000000000000
0000000000000000000000000000000000000000000000000000000000000000000000000000000000000000000000000000
0000000000000000000000000000000000000000000000000000000000000000000000000000000000000000000000000000
0000000000000000000000000000000000000000000000000000000000000000000000000000000000000000000000000000
0000000000000000000000000000000000000000000000000000000000000000000000000000000000000000000000000000
0000000000000000000000000000000000000000000000000000000000000000000000000000000000000000000000000000
0000000000000000000000000000000000000000000000000000000000000000000000000000000000000000000000000000
0000000000000000000000000000000000000000000000000000000000000000000000000000000000000000000000000000
0000000000000000000000000000000000000000000000000000000000000000000000000000000000000000000000000000
0000000000000000000000000000000000000000000000000000000000000000000000000000000000000000000000000000
0000000000000000000000000000000000000000000000000000000000000000000000000000000000000000000000000000
0000000000000000000000000000000000000000000000000000000000000000000000000000000000000000000000000000
0000000000000000000000000000000000000000000000000000000000000000000000000000000000000000000000000000
0000000000000000000000000000000000000000000000000000000000000000000000000000000000000000000000000000
0000000000000000000000000000000000000000000000000000000000000000000000000000000000000000000000000000
0000000000000000000000000000000000000000000000000000000000000000000000000000000000000000000000000000
0000000000000000000000000000000000000000000000000000000000000000000000000000000000000000000000000000
0000000000000000000000000000000000000000000000000000000000000000000000000000000000000000000000000000
0000000000000000000000000000000000000000000000000000000000000000000000000000000000000000000000000000
0000000000000000000000000000000000000000000000000000000000000000000000000000000000000000000000000000
0000000000000000000000000000000000000000000000000000000000000000000000000000000000000000000000000000
0000000000000000000000000000000000000000000000000000000000000000000000000000000000000000000000000000
0000000000000000000000000000000000000000000000000000000000000000000000000000000000000000000000000000
0000000000000000000000000000000000000000000000000000000000000000000000000000000000000000000000000000
0000000000000000000000000000000000000000000000000000000000000000000000000000000000000000000000000000
0000000000000000000000000000000000000000000000000000000000000000000000000000000000000000000000000000
0000000000000000000000000000000000000000000000000000000000000000000000000000000000000000000000000000
0000000000000000000000000000000000000000000000000000000000000000000000000000000000000000000000000000
0000000000000000000000000000000000000000000000000000000000000000000000000000000000000000000000000000
0000000000000000000000000000000000000000000000000000000000000000000000000000000000000000000000000000
0000000000000000000000000000000000000000000000000000000000000000000000000000000000000000000000000000
0000000000000000000000000000000000000000000000000000000000000000000000000000000000000000000000000000
0000000000000000000000000000000000000000000000000000000000000000000000000000000000000000000000000000
0000000000000000000000000000000000000000000000000000000000000000000000000000000000000000000000000000
0000000000000000000000000000000000000000000000000000000000000000000000000000000000000000000000000000
0000000000000000000000000000000000000000000000000000000000000000000000000000000000000000000000000000
0000000000000000000000000000000000000000000000000000000000000000000000000000000000000000000000000000
0000000000000000000000000000000000000000000000000000000000000000000000000000000000000000000000000000
0000000000000000000000000000000000000000000000000000000000000000000000000000000000000000000000000000
0000000000000000000000000000000000000000000000000000000000000000000000000000000000000000000000000000
0000000000000000000000000000000000000000000000000000000000000000000000000000000000000000000000000000
0000000000000000000000000000000000000000000000000000000000000000000000000000000000000000000000000000
0000000000000000000000000000000000000000000000000000000000000000000000000000000000000000000000000000
0000000000000000000000000000000000000000000000000000000000000000000000000000000000000000000000000000
0000000000000000000000000000000000000000000000000000000000000000000000000000000000000000000000000000
0000000000000000000000000000000000000000000000000000000000000000000000000000000000000000000000000000
0000000000000000000000000000000000000000000000000000000000000000000000000000000000000000000000000000
0000000000000000000000000000000000000000000000000000000000000000000000000000000000000000000000000000
0000000000000000000000000000000000000000000000000000000000000000000000000000000000000000000000000000
0000000000000000000000000000000000000000000000000000000000000000000000000000000000000000000000000000
0000000000000000000000000000000000000000000000000000000000000000000000000000000000000000000000000000
