00000IIIIIIIIIIIIIIIIIIIIIIIIIIIIIIIIIIIIIIIIIIIIIIIIIIIIIIIIIIIIIIIII000000000000000000000000000000
IIIIII0000010000000000000000000000000t0000001I000000000000000000000000I00000000000000000000000000000
I000000000010000000000000000000000000t000000100e0111111110000000000000I00000000000000000000000000000
I000000000010000000000000000000000000t0000001I000100000B00001110000000I00000000000000000000000000000
I000000000010000000000000000000000000t0000001I001100000100000000001100I00000000000000000000000000000
I000000000010000000000000000000000000t0000001I00100010010000t100000000I00000000000000000000000000000
I000000000010000000000000000000000000t0000001I001000100100000101000000I00000000000000000000000000000
I0IIII1000010000000000000000000000000t0000001I0I1000100I00000000110000I00000000000000000000000000000
I000I11100010000000000000000000000000t0000001I0I1000100I00000000100000I00000000000000000000000000000
I700I11110010000000000000000000000000t0000001I0I100010eI00000110000000I00000000000000000000000000000
II70I0000001E000000000000000000000000t0000001I0I1005100100001000001000I00000000000000000000000000000
I000I0000001111111111111111111111111111111101I0I10011e0100000001100000I00000000000000000000000000000
I009I0000111IIIIIIIIIIIIIIIIIIIIIIIIIIIIII101I0I10041WW100000000110001000000000000000000000000000000
I09II0000001000000000000000000000000000000101I0I13001WW100000100000001I00000000000000000000000000000
I000I1100001000000000000000000000000000000101I0I11001WW100000000e00000I00000000000000000000000000000
I700I0000001@00000000000000000000000000000101I0I12051WW1000000000001000I0000000000000000000000000000
II70I0000111WWWWWWWWWWWWW000011300005111I0101I0I10011WW1000010000100000I0000000000000000000000000000
I000I0000001LLLLLLL111111LLLLLLLLLLLLLLLI0101I0I13041WW100e000000000000I0000000000000000000000000000
I009I00S0001LLLLLLL111111LLLLLLLLLLLLLLLI0101I0I11001WW1110000100100000I0000000000000000000000000000
I09II1111111LLLLLLL111111111111111111111I0101I0I12051WW1b100P0000010000I0000000000000000000000000000
I00000000001LLLLLLL11000000000000000000000101I0I10011WWWW10000000001000I0000000000000000000000000000
I70000000001111111112000005111111111111111101I0I1304111111000e00000000II0000000000000000000000000000
II7000000001000000000511111200000000001IIII01I0I110000010000011011000eI00000000000000000000000000000
III700000001000IIIIIIIIIIII000000000001000001I0I11000001001001000010000I0000000000000000000000000000
IIII700000010000000I00000I00001WWWW1001000000I0IIIIII001000000000010000I0000000000000000000000000000
IIIII7000001000e000Ie00e0I0e001WWLL1001000000I0I0000I001000000000000000I0000000000000000000000000000
IIIIII7000010000000000000000001WWWW100100IILLI0000I0I001IIIIIIIIIIIIIIII0000000000000000000000000000
111111100001II30005130005130051WWWW1001000ILLI7r9700I001t00000000000000I0000000000000000000000000000
1000000000000tI0004120004120041LLWW1001000IIIIIIII00I00100000000000000tI0000000000000000000000000000
10000000000000II000000000000001WWWW100100000100000000011000011011300000I0000000000000000000000000000
1000000000000001LLLLLLLLLLLLLL1WWWW10010000010000009I010000111011130000I0000000000000000000000000000
1000000000000001LLLLLLLLLLLLLL1WWLL100100000R000009II010001111011113000I0000000000000000000000000000
1WWWWWWWWWWWWWWWWWWWWWWWWWWWWW1WWWW1001IIIIIIIIIIIIII010011111011111000I0000000000000000000000000000
1WWWWWWWWWWWWWWWWWWWWWWWWWWWWW1WWWW100100000000000001010011111011111000I0000000000000000000000000000
1WWWWWWWWWWWWW11WWWWWWWWWWWWWW1WWW1100100000000000001010000000t00000000I0000000000000000000000000000
1WWWWWWWW513WWWWWW5111111111WWWWW11001100e0000000e001010011111011111000I0000000000000000000000000000
1WWWWWWW52013WWWW511111111111WWWW10011000000000000001010041111011112000I0000000000000000000000000000
1111111120g111111111111111111111110110000000000000001010004111011120000I0000000000000000000000000000
11111112052000000000000000000000000G00000000000000001010000411011200000I0000000000000000000000000000
00001000520000000000000000000009111100000000000000001011100011012000000I0000000000000000000000000000
0001000520000001000000001000009I000000000e0000000e0010000051000005LLLLLI0000000000000000000000000000
001000120000000000000000000009I200000000000000000000111111200e0001LLLLLI0000000000000000000000000000
01000120000100000000000000009I2WWWWWWWWWWWWWWWWWWWWW10000000000001LLLLL10000000000000000000000000000
100012000000000000000e000009I2WWWWWWWWWWWWWWWWWWWWWW100000111111111111110000000000000000000000000000
10012e001000000000000000009I2WWWWWWWWWWWWWWWWWWWWWWW10000100000001LLLLL10000000000000000000000000000
100100000000e00000e0000009I2WWWWWWWWWWWWWWWWWWWWWWWWW1001000000001LLLLL10000000000000000000000000000
1001300000000000000000009I1WWWWWWWWWWWWWWWWWWWWWWWWWWW1Y1000000001LLLLL10000000000000000000000000000
0100130e0000000e00000009I043WWWWWWWWWWWWWWWWWWWWWWWWW0001WWWWWWWW1LLLLL10000000000000000000000000000
00100130000000000000009I00043WWWWWWWWWWWWWWWWWWWWWW5111111111111111111110000000000000000000000000000
0001001300000000000009I0000043WWWWWWWWWWWWWWWWWWWW51000000000000000000000000000000000000000000000000
000010013e0000000e009I0000000413WWWWWWWWWWWWWWWWW510000000000000000000000000000000000000000000000000
0000010011113051IIIII00000e00004113WWWWWWWWWWWWW5100000000000000000000000000000000000000000000000000
0000001000001F11IIIIIy000000000000413WWWWWW511111000000000000000000000000000000000000000000000000000
0000000100000011IIIIWWWWWWWWWWWWWWWW411W111100000000000000000000000000000000000000000000000000000000
0000000011111111III1111111WWWWWWWWWWWWWW100000000000000000000000000000000000000000000000000000000000
0000000000000000I1I111111111111111111111100000000000000000000000000000000000000000000000000000000000
0000000000000000000000000000000000000000000000000000000000000000000000000000000000000000000000000000
0000000000000000000000000000000000000000000000000000000000000000000000000000000000000000000000000000
0000000000000000000000000000000000000000000000000000000000000000000000000000000000000000000000000000
0000000000000000000000000000000000000000000000000000000000000000000000000000000000000000000000000000
0000000000000000000000000000000000000000000000000000000000000000000000000000000000000000000000000000
0000000000000000000000000000000000000000000000000000000000000000000000000000000000000000000000000000
0000000000000000000000000000000000000000000000000000000000000000000000000000000000000000000000000000
0000000000000000000000000000000000000000000000000000000000000000000000000000000000000000000000000000
0000000000000000000000000000000000000000000000000000000000000000000000000000000000000000000000000000
0000000000000000000000000000000000000000000000000000000000000000000000000000000000000000000000000000
0000000000000000000000000000000000000000000000000000000000000000000000000000000000000000000000000000
0000000000000000000000000000000000000000000000000000000000000000000000000000000000000000000000000000
0000000000000000000000000000000000000000000000000000000000000000000000000000000000000000000000000000
0000000000000000000000000000000000000000000000000000000000000000000000000000000000000000000000000000
0000000000000000000000000000000000000000000000000000000000000000000000000000000000000000000000000000
0000000000000000000000000000000000000000000000000000000000000000000000000000000000000000000000000000
0000000000000000000000000000000000000000000000000000000000000000000000000000000000000000000000000000
0000000000000000000000000000000000000000000000000000000000000000000000000000000000000000000000000000
0000000000000000000000000000000000000000000000000000000000000000000000000000000000000000000000000000
0000000000000000000000000000000000000000000000000000000000000000000000000000000000000000000000000000
0000000000000000000000000000000000000000000000000000000000000000000000000000000000000000000000000000
0000000000000000000000000000000000000000000000000000000000000000000000000000000000000000000000000000
0000000000000000000000000000000000000000000000000000000000000000000000000000000000000000000000000000
0000000000000000000000000000000000000000000000000000000000000000000000000000000000000000000000000000
0000000000000000000000000000000000000000000000000000000000000000000000000000000000000000000000000000
0000000000000000000000000000000000000000000000000000000000000000000000000000000000000000000000000000
0000000000000000000000000000000000000000000000000000000000000000000000000000000000000000000000000000
0000000000000000000000000000000000000000000000000000000000000000000000000000000000000000000000000000
0000000000000000000000000000000000000000000000000000000000000000000000000000000000000000000000000000
0000000000000000000000000000000000000000000000000000000000000000000000000000000000000000000000000000
0000000000000000000000000000000000000000000000000000000000000000000000000000000000000000000000000000
0000000000000000000000000000000000000000000000000000000000000000000000000000000000000000000000000000
0000000000000000000000000000000000000000000000000000000000000000000000000000000000000000000000000000
0000000000000000000000000000000000000000000000000000000000000000000000000000000000000000000000000000
0000000000000000000000000000000000000000000000000000000000000000000000000000000000000000000000000000
0000000000000000000000000000000000000000000000000000000000000000000000000000000000000000000000000000
0000000000000000000000000000000000000000000000000000000000000000000000000000000000000000000000000000
0000000000000000000000000000000000000000000000000000000000000000000000000000000000000000000000000000
0000000000000000000000000000000000000000000000000000000000000000000000000000000000000000000000000000
00000000000000000000000000000001 1111110000000000000000000000000000000000000000000000000000000000000
0000000000000000000000000000001WWWWWWWW1000000000000000000000000000000000000000000000000000000000000
0000000000000000000000000000001WWWWWWWW1000000000000000000000000000000000000000000000000000000000000
0000000000000000000000000000001WWWWWWWW1000000000000000000000000000000000000000000000000000000000000
0000000000000000000000000000000111111110000000000000000000000000000000000000000000000000000000000000
