0000000000000000000000000000000000000000000000000000000000000000000000000000000000000000000000000000
0000000000000000000000000000000000000000000000000000000000000000000000000000000000000000000000000000
0000000000000000000000000000000000000000000000000000000000000000000000000000000000000000000000000000
0000000000000000000000000000000000000000000000000000000000000000000000000E00000000000000000000000000
0000000000000000000000000000000000000000000000000000000000000000000000001110000000000000000000000000
0000011100000000000000000000000000000000000000000000000000000000000000001W10000000000000000000000000
000001W100000000000000000000000000000000000000000000000000000000000000001W10000000000000000000000000
000001W100000000000000000000000000000000000000000000000000000000000000001W10000000000000000000000000
000001W100000000000000000000000000000000000000000000000000000000000000001W10000000000000000000000000
000001W100000000000000000000000000000000000000000000000000000000000000001W10000000000000000000000000
000001W100000000000000000000000000000000000000000000000000000000000000001W10000000000000000000000000
00000WW100000000000000000000000000000000000000000000000000000000000000001WW0000000000000000000000000
000001W100000000000000000000000000000000000000000000000000000000000000001W10000000000000000000000000
000001W100000000000000000000000000000000000000000000000000000000000000001W10000000000000000000000000
000001W100000000000000000000000000000000000000000000000000000000000000001W10000000000000000000000000
000001W100000000000000000000000000000000000000000000000000000000000000001W10000000000000000000000000
000001W100000000000000000000000000000000000000000000000000000000000000001W10000000000000000000000000
000001W100000000000000000000000000000000000000000000000000000000000000001W10000000000000000000000000
000001W100000000000000000000000000000000000000000000000000000000000000001W10000000000000000000000000
000001W100000000000000000000000000000000000000000000000000000000000000001W10000000000000000000000000
000001W100000000000000000000000000000000000000000000000000000000000000001W10000000000000000000000000
000001W100001111111111111111111111111111111111111111111111111111110000001W10000000000000000000000000
000001W100001000000100000000000000000000000000000000000010000000010000001W10000000000000000000000000
000001W100001000000100000000000000000000000000000000000010000000010000001W10000000000000000000000000
000001W100001000000100000000000000000000000000000000000010000000010000001W10000000000000000000000000
000001W100001000000100000000000000000000000000000000000010000000010000001W10000000000000000000000000
000001W100001000000100000000000000000000000000000000000010000000010000001W10000000000000000000000000
000001W100001000000100000000000000000000000000000000000010000000010000001W10000000000000000000000000
000001W100001000000101111000000000000000000000000001111010000000010000001W10000000000000000000000000
000001W100001000000101001000000000000000000000000001001010000000010000001W10000000000000000000000000
000001W100001000000101001000000000000000000000000001001010000000010000001W10000000000000000000000000
000001W100001000000101001000000000000000000000000001001010000000010000001W10000000000000000000000000
000001W100001000000101001000000000000S00000000000001001010000000010000001W10000000000000000000000000
000001W100001000000101001sssss100IIIIIIIIII001sssss1001010000000010000001W10000000000000000000000000
000001W100001000000101001sssss1001111111111001sssss1001010000000010000001W10000000000000000000000000
000001W100001000000101001sssss1001111111111001sssss1001010000000010000001W10000000000000000000000000
000001W100001000000101001sssss1001111111111001sssss1001010000000010000001W10000000000000000000000000
000001W100001000000402001sssss1001111111111001sssss1004020000000010000001W10000000000000000000000000
000001W100001000000000001111112001111111111004111111000000000000010000001W10000000000000000000000000
000001W100001000000000000000000001111111111000000000000000000000010000001W10000000000000000000000000
000001W100001000000000000000000001111111111000000000000000000000010000001W10000000000000000000000000
000001W100001000000000000LLLLLLLL1111111111LLLLLLLLL000000000000010000001W10000000000000000000000000
000001W100001W11L1L1L1L1L1111111111111111111111111111L1L1L1L1L11W10000001W10000000000000000000000000
000001W100001W1LLLLLLLLLLLLLLLLLLLLLLLLLLLLLLLLLLLLLLLLLLLLLLLL1W10000001W10000000000000000000000000
000001W100001W1LLLLLLLLLLLLLLLLLLLLLLLLLLLLLLLLLLLLLLLLLLLLLLLL1W10000001W10000000000000000000000000
000001W111111W1LLLLLLLLLLLLLLLLLLLLLLLLLLLLLLLLLLLLLLLLLLLLLLLL1W11111111W10000000000000000000000000
000001WWWWWWWW1LLLLLLLLLLLLLLLLLLLLLLLLLLLLLLLLLLLLLLLLLLLLLLLL1WWWWWWWWWW10000000000000000000000000
000001LLLLLLLL11111111111111111111111111111111111111111111111111LLLLLLLLLL10000000000000000000000000
000001LLLLLLLL00000000000000000000000000000000000000000000000000LLLLLLLLLL10000000000000000000000000
000001LLLLLLLL00000000000000000000000000000000000000000000000000LLLLLLLLLL10000000000000000000000000
0000011111111111111ssssssssssssssssssssssssssssssssssssssss11111111111111110000000000000000000000000
00000ssssssssssssssssssssssssssssssssssssssssssssssssssssssssssssssssssssss0000000000000000000000000
00000LLLLLLLLLLLLLLLLLLLLLLLLLLLLLLLLLLLLLLLLLLLLLLLLLLLLLLLLLLLLLLLLLLLLLL0000000000000000000000000
0000000000000000000000000000000000000000000000000000000000000000000000000000000000000000000000000000
0000000000000000000000000000000000000000000000000000000000000000000000000000000000000000000000000000
0000000000000000000000000000000000000000000000000000000000000000000000000000000000000000000000000000
0000000000000000000000000000000000000000000000000000000000000000000000000000000000000000000000000000
0000000000000000000000000000000000000000000000000000000000000000000000000000000000000000000000000000
0000000000000000000000000000000000000000000000000000000000000000000000000000000000000000000000000000
0000000000000000000000000000000000000000000000000000000000000000000000000000000000000000000000000000
0000000000000000000000000000000000000000000000000000000000000000000000000000000000000000000000000000
0000000000000000000000000000000000000000000000000000000000000000000000000000000000000000000000000000
0000000000000000000000000000000000000000000000000000000000000000000000000000000000000000000000000000
0000000000000000000000000000000000000000000000000000000000000000000000000000000000000000000000000000
0000000000000000000000000000000000000000000000000000000000000000000000000000000000000000000000000000
0000000000000000000000000000000000000000000000000000000000000000000000000000000000000000000000000000
0000000000000000000000000000000000000000000000000000000000000000000000000000000000000000000000000000
0000000000000000000000000000000000000000000000000000000000000000000000000000000000000000000000000000
0000000000000000000000000000000000000000000000000000000000000000000000000000000000000000000000000000
0000000000000000000000000000000000000000000000000000000000000000000000000000000000000000000000000000
0000000000000000000000000000000000000000000000000000000000000000000000000000000000000000000000000000
0000000000000000000000000000000000000000000000000000000000000000000000000000000000000000000000000000
0000000000000000000000000000000000000000000000000000000000000000000000000000000000000000000000000000
0000000000000000000000000000000000000000000000000000000000000000000000000000000000000000000000000000
0000000000000000000000000000000000000000000000000000000000000000000000000000000000000000000000000000
0000000000000000000000000000000000000000000000000000000000000000000000000000000000000000000000000000
0000000000000000000000000000000000000000000000000000000000000000000000000000000000000000000000000000
0000000000000000000000000000000000000000000000000000000000000000000000000000000000000000000000000000
0000000000000000000000000000000000000000000000000000000000000000000000000000000000000000000000000000
0000000000000000000000000000000000000000000000000000000000000000000000000000000000000000000000000000
0000000000000000000000000000000000000000000000000000000000000000000000000000000000000000000000000000
0000000000000000000000000000000000000000000000000000000000000000000000000000000000000000000000000000
0000000000000000000000000000000000000000000000000000000000000000000000000000000000000000000000000000
0000000000000000000000000000000000000000000000000000000000000000000000000000000000000000000000000000
0000000000000000000000000000000000000000000000000000000000000000000000000000000000000000000000000000
0000000000000000000000000000000000000000000000000000000000000000000000000000000000000000000000000000
0000000000000000000000000000000000000000000000000000000000000000000000000000000000000000000000000000
0000000000000000000000000000000000000000000000000000000000000000000000000000000000000000000000000000
0000000000000000000000000000000000000000000000000000000000000000000000000000000000000000000000000000
0000000000000000000000000000000000000000000000000000000000000000000000000000000000000000000000000000
0000000000000000000000000000000000000000000000000000000000000000000000000000000000000000000000000000
0000000000000000000000000000000000000000000000000000000000000000000000000000000000000000000000000000
0000000000000000000000000000000000000000000000000000000000000000000000000000000000000000000000000000
0000000000000000000000000000000000000000000000000000000000000000000000000000000000000000000000000000
0000000000000000000000000000000000000000000000000000000000000000000000000000000000000000000000000000
0000000000000000000000000000000000000000000000000000000000000000000000000000000000000000000000000000
0000000000000000000000000000000000000000000000000000000000000000000000000000000000000000000000000000
0000000000000000000000000000000000000000000000000000000000000000000000000000000000000000000000000000
0000000000000000000000000000000000000000000000000000000000000000000000000000000000000000000000000000
0000000000000000000000000000000000000000000000000000000000000000000000000000000000000000000000000000
