000001IIIIIIIIIIIIIII1III1IIIIIIIII5IIIIIIIIIIIIIIII00IIII8IIIII130000000000000000000000000000000000
111100000001000000001000000000005000000000001I000000000000000000110000000000000000000000000000000000
I00000000001E000000000000e0000000000000000t0100e0000000000000000110000000000000000000000000000000000
I00000000001111110000000000000000000000000001I0000000000000t0000010000000000000000000000000000000000
I00000000001IIIII1000000000000000000000000001I000000111100000000010000000000000000000000000000000000
I0000000000000000I100000000000000000000000001I000000100100090000010000000000000000000000000000000000
I00000000000000000I11000000000000000000010001I00I000100100000000010000000000000000000000000000000000
I00000000000000000001000000000000000000000001I0I1000100100000000010000000000000000000000000000000000
I00000000000000000001000000100010010100000001I0I1000100100000000010000000000000000000000000000000000
I00000000000000111111000000000000000000000001I0I100010e100000000010000000000000000000000000000000000
I0011IIIIIII300000001000000000000000000000001I0I1000I00100001111110000000000000000000000000000000000
I0010000000I1111111110I0I0I0I0I0I0I0III000001I0I1000Ie010000B0b0010000000000000000000000000000000000
I0010010000I00101000000000000000000000I000001I0I1000IWW111111110010000000000000000000000000000000000
I0010010000I001P1000000000000000000000I000001I0I1300IWW100000000010000000000000000000000000000000000
I0010010000000101000000000000000000000I000001I0I11001WW100000000010000000000000000000000000000000000
I0010010000I000010000000000000000000000000001I0I12051WW100000000010000000000000000000000000000000000
I1010013000IIIWWWWWI0II30000005300005111I0001I0I10011WW100000000010000000000000000000000000000000000
I0000011305II0LLLLL11LLLLLLLLLLLLLLLLLLLII001I0I13041WW100000000010000000000000000000000000000000000
I000001110IIIILLLLL11LLLLLLLLLLLLLLLLLLLII001I0I11001WW100000000010000000000000000000000000000000000
I00000111LIIIILLLLL111111111111111111111I0001I0I12051WW10000P000010000000000000000000000000000000000
I0000011LLL1IILLLLL11000000000000000001000001I0I10011WW100000000010000000000000000000000000000000000
I7000001LLL1111111112000005111111111001000001I0I13041WW100000000010000000000000000000000000000000000
II700000111100000000051111120000000I001e00001I0I11001WW100000000010000000000000000000000000000000000
III700000001000IIIIIIIIIIII0001WWWWI001001111I0I12051WW100000000010000000000000000000000000000000000
IIII700000010000000000000000001WWWWI301000000IrI10011WW100000000011000000000000000000000000000000000
IIIII7000001000e0000e00e000e001WWLLI051000000I0I10041WW100000000001000000000000000000000000000000000
IIIIII7000010000000000000000001WWWWI30100IILLI08I7001WWIIIIIIIIIIIIIIIII0000000000000000000000000000
111111100001II3000513000513005IWWWWI051000ILLI708I001WWIt00000000000000I0000000000000000000000000000
1000000000000tI000412000412004ILLWWI301000IIIII70I001WWI00000000000000tI0000000000000000000000000000
10000000000000II00000000000000IWWWWI0510000010000I0011II000011011300000I0000000000000000000000000000
1000000000000001LLLLLLLLLLLLLL1WWWWI30100000R000000000I0000111011130000I0000000000000000000000000000
1000000000000001LLLLLLLLLLLLLL1WWLLI051000111111100000I0001111011113000I0000000000000000000000000000
1WWWWWWWWWWWWWWWWWWWWWWWWWWWWWWWWWWI001000000000000000I0011111011111000I0000000000000000000000000000
1WWWWWWWWWWWWWWWWWWWWWWWWWWWWWWWWWWI001LLLLLLLLLL11110I0011111011111000I0000000000000000000000000000
1WWWWWWWWWWWWWW1LLLLLLLLLLLLLLLL111I001111111111111110I0000000t00000000I0000000000000000000000000000
1WWWWWWWWWWWWWW111111111111111111100000010000000000010I0011111011111000I0000000000000000000000000000
1WWWWWWWWWWWWWWWWWWWWWWWWWWWWWG04100000010000e0000e010I0011111011112000I0000000000000000000000000000
1W1111111111111111111111111111110100000010000ee0000010I0041111011120000I0000000000000000000000000000
1W1000000000000000000000e00000000100000010000000000010I0004111011200000I0000000000000000000000000000
1W100000000000000001100000000009I2WWWWWW1WWWWWWWWWWW1011100111012000000I0000000000000000000000000000
11111111111010000000000e0000009I2WWWWWWW1WWWWWWWWWWW100Y0052000005LLLLLI0000000000000000000000000000
1000I0000000100e00000000000009I2WWWWW1WW1WWWWWWWWtWW11111120000001LLLLLI0000000000000000000000000000
1000I000000010000000011110009I2WWWWWWWWW1WWWW1WWWWWW100000y0000001LLLLL10000000000000000000000000000
1000I00000001000000000000009I2WWWW53WWWW1WWWWWWWWWWW100000111111111111110000000000000000000000000000
100000000000100111100000009I2WWWWW42WWWWWWWWWWW11WWW10000100000001LLLLL10000000000000000000000000000
10000000000010001000000009I2WWWWWWWWWWWWWWWWWWW11WWWW1S01000000001LLLLL10000000000000000000000000000
100000000000I000100000009I1WWWWWWWWWWWWWWWWWWWWWWWWWWW101000000001LLLLL10000000000000000000000000000
100000000000I00010000009I043WWWWWWWWWWWWWWWWWWWWWW1WW0001WWWWWWWW1LLLLL10000000000000000000000000000
100000000000I0001000009I00043WWW1WWWWWWWWWWtWWWWWWW5111111111111111111110000000000000000000000000000
1111000000000000100009I0000043WWWWWWWWWWWWWWWWWWWW51000000000000000000000000000000000000000000000000
I00000000000000010009I0000000413WWWWWWWWWWWWWWWWW510000000000000000000000000000000000000000000000000
I0000000000000001009I00000000004113WWWWWWWWWWWWW5100000000000000000000000000000000000000000000000000
ILLLLLLLLLLLLL10009II0000000000000413WWWWWW511111000000000000000000000000000000000000000000000000000
I00000000000000009I5WWWWWWWWWWWWWWWW411W111100000000000000000000000000000000000000000000000000000000
Ig000000000000009II1111111WWWWWWWWWWWWWW100000000000000000000000000000000000000000000000000000000000
IIIIIIIIIIIIIIIII1I111111111111111111111100000000000000000000000000000000000000000000000000000000000
0000000000000000000000000000000000000000000000000000000000000000000000000000000000000000000000000000
0000000000000000000000000000000000000000000000000000000000000000000000000000000000000000000000000000
0000000000000000000000000000000000000000000000000000000000000000000000000000000000000000000000000000
0000000000000000000000000000000000000000000000000000000000000000000000000000000000000000000000000000
0000000000000000000000000000000000000000000000000000000000000000000000000000000000000000000000000000
0000000000000000000000000000000000000000000000000000000000000000000000000000000000000000000000000000
0000000000000000000000000000000000000000000000000000000000000000000000000000000000000000000000000000
0000000000000000000000000000000000000000000000000000000000000000000000000000000000000000000000000000
0000000000000000000000000000000000000000000000000000000000000000000000000000000000000000000000000000
0000000000000000000000000000000000000000000000000000000000000000000000000000000000000000000000000000
0000000000000000000000000000000000000000000000000000000000000000000000000000000000000000000000000000
0000000000000000000000000000000000000000000000000000000000000000000000000000000000000000000000000000
0000000000000000000000000000000000000000000000000000000000000000000000000000000000000000000000000000
0000000000000000000000000000000000000000000000000000000000000000000000000000000000000000000000000000
0000000000000000000000000000000000000000000000000000000000000000000000000000000000000000000000000000
0000000000000000000000000000000000000000000000000000000000000000000000000000000000000000000000000000
0000000000000000000000000000000000000000000000000000000000000000000000000000000000000000000000000000
0000000000000000000000000000000000000000000000000000000000000000000000000000000000000000000000000000
0000000000000000000000000000000000000000000000000000000000000000000000000000000000000000000000000000
0000000000000000000000000000000000000000000000000000000000000000000000000000000000000000000000000000
0000000000000000000000000000000000000000000000000000000000000000000000000000000000000000000000000000
0000000000000000000000000000000000000000000000000000000000000000000000000000000000000000000000000000
0000000000000000000000000000000000000000000000000000000000000000000000000000000000000000000000000000
0000000000000000000000000000000000000000000000000000000000000000000000000000000000000000000000000000
0000000000000000000000000000000000000000000000000000000000000000000000000000000000000000000000000000
0000000000000000000000000000000000000000000000000000000000000000000000000000000000000000000000000000
0000000000000000000000000000000000000000000000000000000000000000000000000000000000000000000000000000
0000000000000000000000000000000000000000000000000000000000000000000000000000000000000000000000000000
0000000000000000000000000000000000000000000000000000000000000000000000000000000000000000000000000000
0000000000000000000000000000000000000000000000000000000000000000000000000000000000000000000000000000
0000000000000000000000000000000000000000000000000000000000000000000000000000000000000000000000000000
0000000000000000000000000000000000000000000000000000000000000000000000000000000000000000000000000000
0000000000000000000000000000000000000000000000000000000000000000000000000000000000000000000000000000
0000000000000000000000000000000000000000000000000000000000000000000000000000000000000000000000000000
0000000000000000000000000000000000000000000000000000000000000000000000000000000000000000000000000000
0000000000000000000000000000000000000000000000000000000000000000000000000000000000000000000000000000
0000000000000000000000000000000000000000000000000000000000000000000000000000000000000000000000000000
0000000000000000000000000000000000000000000000000000000000000000000000000000000000000000000000000000
0000000000000000000000000000000000000000000000000000000000000000000000000000000000000000000000000000
00000000000000000000000000000001 1111110000000000000000000000000000000000000000000000000000000000000
0000000000000000000000000000001WWWWWWWW1000000000000000000000000000000000000000000000000000000000000
0000000000000000000000000000001WWWWWWWW1000000000000000000000000000000000000000000000000000000000000
0000000000000000000000000000001WWWWWWWW1000000000000000000000000000000000000000000000000000000000000
0000000000000000000000000000000111111110000000000000000000000000000000000000000000000000000000000000
